33333333333333333333333333333333333333333333333333333333333333333333333333333333333333333333333333333333333333
3............................................................................................................3
3............................................................................................................3
3............................................................................................................3
3............................................................................................................3
3............................................................................................................3
3............................................................................................................3
3............................................................................................................3
3............................................................................................................3
3............................................................................................................3
3............................................................................................................3
3............................................................................................................3
3............................................................................................................3
3............................................................................................................3
3............................................................................................................3
3............................................................................................................3
3............................................................................................................3
3............................................................................................................3
3............................................................................................................3
3............................................................................................................3
3............................................................................................................3
3............................................................................................................3
3............................................................................................................3
3............................................................................................................3
3............................................................................................................3
3............................................................................................................3
3............................................................................................................3
3....P.......................................................................................................3
3............................................................................................................3
11111111111111111111111111111111111111111111111111111111111111111111111111111111111111111111111111111111111111
